
@parallax-layer bg1
@parallax-layer bg2
@music music

    AAAAAAAAAAAAAAAAAAAAAAAAAAAAAAAAAAAAAAAAAAAAAA
    AAAAAAAAAAAAAAAAAAAAAAAAAAAAAAAAAAAAAAAAAAAAAA
    AAAAAAAAAAAAAAAAAAAAAAAAAAAAAAAAAAAAAAAAAAAAAA
    AAAANJJJJJJJJJJJJJJJJJJJJJJJJJJJJJJJJJJJJMAAAA
    AAAAD                                    CAAAA
    AAAAD                                    CAAAA
    AAAAD                                    CAAAA
    AAAAD                                    CAAAA
    AAAAD                                    CAAAA
    AAAAD                                    CAAAA
    AAAAD                  **          ?     CAAAA
    AAAAD        b b m c 0       s   b %     CAAAA
    AAAAHBBBBBBBBBBBBBBBBBBBBBBBBBBBBBBBBBBBBGAAAA
    AAAAAAAAAAAAAAAAAAAAAAAAAAAAAAAAAAAAAAAAAAAAAA
    AAAAAAAAAAAAAAAAAAAAAAAAAAAAAAAAAAAAAAAAAAAAAA
    AAAAAAAAAAAAAAAAAAAAAAAAAAAAAAAAAAAAAAAAAAAAAA
           
