
@parallax-layer bg1
@parallax-layer bg2
@music music

    AAAAAAAAAAAAAAAAAAAAAAAAAAAAAAAAAAAAAAAAAAAAAAAAAAAAAAAAAA
    AAAAAAAAAAAAAAAAAAAAAAAAAAAAAAAAAAAAAAAAAAAAAAAAAAAAAAAAAA
    AAAAAAAAAAAAAAAAAAAAAAAAAAAAAAAAAAAAAAAAAAAAAAAAAAAAAAAAAA
    AAAANJJJJJJJJJJJJJJJJJJJJJJJJJJJJJJJJJJJJJJJJJJJJJMAAAAAAA
    AAAAD           *                                   CAAAAA
    AAAAD           s                                   CAAAAA
    AAAAD        HBBBBBM                                CAAAAA
    AAAAD        NJJJJJG                  ?       *     CAAAAA
    AAAAD                       *  *              b %   CAAAAA
    AAAAD                      HBBBBM           CBBBBBBBGAAAAA
    AAAAHBBBBBBF               NJJJJG           CAAAAAAAAAAAAA
    AAAAAAAAAAAD   0                            CAAAAAAAAAAAAA
    AAAAAAAAAAAHBBBBBBBBF                  !    CAAAAAAAAAAAAA
    AAAAAAAAAAAAAAAAAAAAD        b b m c        CAAAAAAAAAAAAA
    AAAAAAAAAAAAAAAAAAAAHBBBBBBBBBBBBBBBBBBBBBBBGAAAAAAAAAAAAA
    AAAAAAAAAAAAAAAAAAAAAAAAAAAAAAAAAAAAAAAAAAAAAAAAAAAAAAAAAA
    AAAAAAAAAAAAAAAAAAAAAAAAAAAAAAAAAAAAAAAAAAAAAAAAAAAAAAAAAA
    AAAAAAAAAAAAAAAAAAAAAAAAAAAAAAAAAAAAAAAAAAAAAAAAAAAAAAAAAA
