
@parallax-layer bg1
@parallax-layer bg2
@music music

    AAAAAAAAAAAAAAAAAAAAAAAAAAAAAAAAAAAAAAAAAAAAAAAAA
    AAAAAAAAAAAAAAAAAAAAAAAAAAAAAAAAAAAAAAAAAAAAAAAAA
    AAAAAAAAAAAAAAAAAAAAAAAAAAAAAAAAAAAAAAAAAAAAAAAAA
    AAAANJJJJJJJJJJJJJJJJJJJJJJJJJJJJJJJJJJJJJJJMAAAA
    AAAAD                                       CAAAA
    AAAAD                                       CAAAA
    AAAAD                                       CAAAA
    AAAAD                                       CAAAA
    AAAAD                                       CAAAA
    AAAAD                                       CAAAA
    AAAAD                                       CAAAA
    AAAAD     0             A              %    CAAAA
    AAAAHBBBBBBBBBBBBBBBBBBBBBBBBBBBBBBBBBBBBBBBGAAAA
    AAAAAAAAAAAAAAAAAAAAAAAAAAAAAAAAAAAAAAAAAAAAAAAAA
    AAAAAAAAAAAAAAAAAAAAAAAAAAAAAAAAAAAAAAAAAAAAAAAAA
    AAAAAAAAAAAAAAAAAAAAAAAAAAAAAAAAAAAAAAAAAAAAAAAAA
