
@parallax-layer bg1
@parallax-layer bg2
@music music


NJJJJJJJJJJJJJJJJJJJJJJJJJJJJJJJJJJJJJJJJJJJJJJJJJJJJJJJJJJJJJJM
L                                                              C
L                                                              C
L0                                                             C
LBBBBB                                                     BBBBC
L                                                              C
L                                                              C
L                                                              C
L                                                              C
L                                                              C
L                                                              C
NBBBBBBBBBBBBBBBBBBBBBBBBBBBBBBBBBBBBBBBBBBBBBBBBBBBBBBBBBBBBBBM
