
@parallax-layer bg1
@parallax-layer bg2
@music music

    AAAAAAAAAAAAAAAAAAAAAAAAAAAAAAAAAAAAAAAAAAAAAAAAAAAAAAAAAA
    AAAAAAAAAAAAAAAAAAAAAAAAAAAAAAAAAAAAAAAAAAAAAAAAAAAAAAAAAA
    AAAAAAAAAAAAAAAAAAAAAAAAAAAAAAAAAAAAAAAAAAAAAAAAAAAAAAAAAA
    AAAANJJJJJJJJJJJJJJJJJJJJJJJJJJJJJJJJJJJJJJJJJJJJJJJMAAAAA
    AAAAD                                               CAAAAA
    AAAAD                                               CAAAAA
    AAAAD                                               CAAAAA
    AAAAD                                               CAAAAA
    AAAAD           A                                   CAAAAA
    AAAAD       EBBBBBBF                                CAAAAA
    AAAAD       KJJJJJJL         A                  0   CAAAAA
    AAAAD                      EBBBBF           EBBBBBBBGAAAAA
    AAAAD                      KJJJJL           CAAAAAAAAAAAAA
    AAAAD                                       CAAAAAAAAAAAAA
    AAAAD                                       CAAAAAAAAAAAAA
    AAAAD   %                           AAAA    CAAAAAAAAAAAAA
    AAAAHBBBBBBBBBBBBBBBBBBBBBBBBBBBBBBBBBBBBBBBGAAAAAAAAAAAAA
    AAAAAAAAAAAAAAAAAAAAAAAAAAAAAAAAAAAAAAAAAAAAAAAAAAAAAAAAAA
    AAAAAAAAAAAAAAAAAAAAAAAAAAAAAAAAAAAAAAAAAAAAAAAAAAAAAAAAAA
    AAAAAAAAAAAAAAAAAAAAAAAAAAAAAAAAAAAAAAAAAAAAAAAAAAAAAAAAAA  
           
