
@parallax-layer bg1
@parallax-layer bg2
@music music

    AAAAAAAAAAAAAAAAAAAAAAAAAAAAAAAAAAAAAAAAAAAAAAAAAAAAAAAAAAAAAAAAAAAAAAAAAAAA
    AAAAAAAAAAAAAAAAAAAAAAAAAAAAAAAAAAAAAAAAAAAAAAAAAAAAAAAAAAAAAAAAAAAAAAAAAAAA
    AAAAAAAAAAAAAAAAAAAAAAAAAAAAAAAAAAAAAAAAAAAAAAAAAAAAAAAAAAAAAAAAAAAAAAAAAAAA
    AAAAAAAAAAAAAAAAAAAAAAAAAAAAAAAAAAAAAAAAAAAAAAAAAAAAAAAAAAAAAAAAAAAAAAAAAAAA
    AAAAANJJJJJJJJJJJJJJJJJJJJJJJJJJJJJJJJJJJJJJJJJJJJJJJJJJJJJJJJJJJJJJJJMAAAAA
    AAAAAD                                                                CAAAAA
    AAAAAD                                                                CAAAAA
    AAAAAD                                                           ?    CAAAAA
    AAAAAD         A                                     A    !           CAAAAA
    AAAAAD        QPPPPPPR                              QPPPPPPR          CAAAAA
    AAAAAD                                 !      A                       CAAAAA
    AAAAAD                               QPPPPPPPPR                       CAAAAA
    AAAAAD                                                                CAAAAA
    AAAAAD                       A      0                                 CAAAAA
    AAAAAD    $ $ m $           QPPPPPPPPPR                     $ $ m $   CAAAAA
    AAAAAHBBBBBBBBBBBBBBBF                                EBBBBBBBBBBBBBBBCAAAAA
    AAAAAAAAAAAAAAAAAAAAAD                                CAAAAAAAAAAAAAAAAAAAAA
    AAAAAAAAAAAAAAAAAAAAAD                                CAAAAAAAAAAAAAAAAAAAAA
    AAAAAAAAAAAAAAAAAAAAAD   A                        A   CAAAAAAAAAAAAAAAAAAAAA    
    AAAAAAAAAAAAAAAAAAAAAHBBBBBBBF                EBBBBBBBGAAAAAAAAAAAAAAAAAAAAA
    AAAAAAAAAAAAAAAAAAAAAAAAAAAAAD                CAAAAAAAAAAAAAAAAAAAAAAAAAAAAA
    AAAAAAAAAAAAAAAAAAAAAAAAAAAAAD       %        CAAAAAAAAAAAAAAAAAAAAAAAAAAAAA
    AAAAAAAAAAAAAAAAAAAAAHBBBBBBBBBBBBBBBBBBBBBBBBGAAAAAAAAAAAAAAAAAAAAAAAAAAAAA
    AAAAAAAAAAAAAAAAAAAAAAAAAAAAAAAAAAAAAAAAAAAAAAAAAAAAAAAAAAAAAAAAAAAAAAAAAAAA
    AAAAAAAAAAAAAAAAAAAAAAAAAAAAAAAAAAAAAAAAAAAAAAAAAAAAAAAAAAAAAAAAAAAAAAAAAAAA
    AAAAAAAAAAAAAAAAAAAAAAAAAAAAAAAAAAAAAAAAAAAAAAAAAAAAAAAAAAAAAAAAAAAAAAAAAAAA
    AAAAAAAAAAAAAAAAAAAAAAAAAAAAAAAAAAAAAAAAAAAAAAAAAAAAAAAAAAAAAAAAAAAAAAAAAAAA